22 2 2 2 2 2 2 2 2 2 2 21
3 23 23 23 23 23 23 23 23 23 23 1
3 23 23 23 23 23 23 23 23 23 23 1
3 23 23 23 23 23 23 23 23 23 23 1
3 23 23 23 23 23 23 23 23 23 23 1
3 23 23 23 23 23 23 23 23 23 23 1
3 23 23 23 23 23 23 23 23 23 23 1
3 23 23 23 23 23 23 23 23 23 23 1
3 23 23 23 23 23 23 23 23 23 23 1
3 23 23 23 23 23 23 23 23 23 23 1
3 23 23 23 23 23 23 23 23 23 23 1
3 23 23 23 23 23 23 23 23 23 23 1
19 0 0 0 0 0 0 0 0 0 0 20