22 2 2 2 2 2 2 2 2 2 2 21
3 22 2 2 9 23 23 23 23 23 23 1
3 9 23 23 23 23 23 23 18 23 23 1
3 23 23 18 23 23 23 23 23 23 23 1
3 23 23 23 23 23 23 5 17 7 23 1
3 23 4 23 23 23 23 23 6 23 23 1
3 23 16 23 23 4 23 23 23 23 23 1
3 23 16 23 23 12 7 23 23 23 23 1
3 23 6 23 23 23 23 23 11 10 23 1
3 23 23 23 23 23 23 23 8 9 23 1
3 23 18 23 23 4 23 23 23 23 23 1
3 23 23 23 11 0 10 23 23 23 23 1
19 0 0 0 0 0 0 0 0 0 0 20